{
  "structure": [
    [1, 1, 1, 1, 1, 1, 1, 1],
    [0, 1, 0, 1, 0, 1, 0, 1],
    [0, 1, 0, 1, 0, 1, 0, 1],
    [0, 1, 0, 1, 0, 1, 0, 1],
    [0, 1, 0, 1, 0, 1, 0, 1],
    [0, 1, 0, 1, 0, 1, 0, 1],
    [0, 1, 0, 1, 0, 1, 0, 1]
  ],
  "levelNumber": 2
}